#################################################
#...#.....#.#...#...#.#.#.#.#...#...#.....#.#.#.#
#.#####.###.#.#####.#.#.#.#.#.###.###.#####.#.#.#
#.....#.#.#.#.#.#.#.#.#.#...#.#.#.....#.....#...#
###.###.#.#.#.#.#.#.#.#.#.###.#.#.###.#.#######.#
#.#...#...#.#.#.#...#.#.....#.#...#*#...#.....#.#
#.#.###.###.#.#.#.###.#.#####.#.###.#####.#####.#
#.#.#...#...#...#.......#...#...#.......#.#...#.#
#.#.#.#####.###.#.#######.#####.#.###.###.#.###.#
#...#.#.#.....#.#.........#.#.....#.#.#.#.......#
#.###.#.#####.#.#.###.#####.#.#####.###.#.#######
#.....#.......#.....#.#.#...#.#.#.#...#.........#
#.###########.###.#####.#.###.#.#.#.###.#####.#.#
#...#...#...#.#.....#.....#...#.#.#.#.#.....#.#.#
###.#.#####.#.#.###.#.#######.#.#.#.#.#.#.#.#####
#.#.#...#...#.....#.#...#.#.#.#.#.......#.#.....#
#.#.#.#####.#.#######.###.#.#.#.#.#############.#
#.....#...#...#.....#...#.#...#.#.............#.#
#####.###.#.###.#####.###.###.#.#.#########.#####
#.....#.....#.#...#.#...#.#.#.#.#.........#.#...#
#####.#####.#.#.###.#.###.#.#.#.#.###########.###
#.#.....#...#.#...#.#.#.#...#.#.#.....#.#...#.#.#
#.#####.###.#.###.#.#.#.#.###.#.#.#####.#.###.#.#
#.#.#.#.#.#.#...#.#...#...#.#.............#...#.#
#.#.#.#.#.#.#.###.#.#####.#.#.###.#########.###.#
#.#.#.#.#.#...#...#.#.#.........#...#...#.#.....#
#.#.#.#.#.#.###.###.#.###.###########.###.#.#####
#.#...#...#.#.#.#.#.....#.........#...#.....#.#.#
#.###.###.#.#.#.#.#.#######.#######.###.#####.#.#
#.#.....#...#.#...#.#.#.#.....#...#.#.....#.....#
#.#####.#.###.#.###.#.#.#.#####.###.#.#####.#####
#.#.#.#.#.....#...#.............#...#...#...#...#
#.#.#.#.#.#####.###.#############.###.###.###.###
#.#.#.#...#...#.#.......#.#.#.#...#.#...#.#.#...#
#.#.#.#.#.#.###.#.#######.#.#.#.###.#.###.#.#.###
#.#.#...#.#.#.#...#.....#.#...........#.#.#.....#
#.#.###.###.#.#.###.#####.#.###########.#.#.#.###
#...#.....#.......#.........................#...#
###.#.###.#.#######.#####.###################.###
#...#...#.#.....#.#.....#...........#...#.#.#...#
###.#.#######.###.#.#######.###.#####.###.#.#####
#.#...#.#.#.#.........#...#.#.#.#...#.#.#.#.#.#.#
#.###.#.#.#.#.#########.#####.###.###.#.#.#.#.#.#
#.#.#.#.....................#...#.......#...#.#.#
#.#.#.###.#############.###.#.###.#######.###.#.#
#.....#.#...........#.#...#.........#...#.......#
#####.#.#.#######.#.#.#########.#####.###.#####.#
#....o..........#.#...........#...............#.#
#################################################