###################################################
#o................................................#
#################################################.#
#...............................................#.#
#.#############################################.#.#
#.#...........................................#.#.#
#.#.#########################################.#.#.#
#.#.#.......................................#.#.#.#
#.#.#.#####################################.#.#.#.#
#.#.#.#...................................#.#.#.#.#
#.#.#.#.#################################.#.#.#.#.#
#.#.#.#.#...............................#.#.#.#.#.#
#.#.#.#.#.#############################.#.#.#.#.#.#
#.#.#.#.#.#...........................#.#.#.#.#.#.#
#.#.#.#.#.#.#########################.#.#.#.#.#.#.#
#.#.#.#.#.#.#.......................#.#.#.#.#.#.#.#
#.#.#.#.#.#.#.#####################.#.#.#.#.#.#.#.#
#.#.#.#.#.#.#.#...................#.#.#.#.#.#.#.#.#
#.#.#.#.#.#.#.#.#################.#.#.#.#.#.#.#.#.#
#.#.#.#.#.#.#.#.#...............#.#.#.#.#.#.#.#.#.#
#.#.#.#.#.#.#.#.#.#############.#.#.#.#.#.#.#.#.#.#
#.#.#.#.#.#.#.#.#.#...........#.#.#.#.#.#.#.#.#.#.#
#.#.#.#.#.#.#.#.#.#.#########.#.#.#.#.#.#.#.#.#.#.#
#.#.#.#.#.#.#.#.#.#.#.......#.#.#.#.#.#.#.#.#.#.#.#
#.#.#.#.#.#.#.#.#.#.#.#####.#.#.#.#.#.#.#.#.#.#.#.#
#.#.#.#.#.#.#.#.#.#.#.#..*#.#.#.#.#.#.#.#.#.#.#.#.#
#.#.#.#.#.#.#.#.#.#.#.#.###.#.#.#.#.#.#.#.#.#.#.#.#
#.#.#.#.#.#.#.#.#.#.#.#.....#.#.#.#.#.#.#.#.#.#.#.#
#.#.#.#.#.#.#.#.#.#.#.#######.#.#.#.#.#.#.#.#.#.#.#
#.#.#.#.#.#.#.#.#.#.#.........#.#.#.#.#.#.#.#.#.#.#
#.#.#.#.#.#.#.#.#.#.###########.#.#.#.#.#.#.#.#.#.#
#.#.#.#.#.#.#.#.#.#.............#.#.#.#.#.#.#.#.#.#
#.#.#.#.#.#.#.#.#.###############.#.#.#.#.#.#.#.#.#
#.#.#.#.#.#.#.#.#.................#.#.#.#.#.#.#.#.#
#.#.#.#.#.#.#.#.###################.#.#.#.#.#.#.#.#
#.#.#.#.#.#.#.#.....................#.#.#.#.#.#.#.#
#.#.#.#.#.#.#.#######################.#.#.#.#.#.#.#
#.#.#.#.#.#.#.........................#.#.#.#.#.#.#
#.#.#.#.#.#.###########################.#.#.#.#.#.#
#.#.#.#.#.#.............................#.#.#.#.#.#
#.#.#.#.#.###############################.#.#.#.#.#
#.#.#.#.#.................................#.#.#.#.#
#.#.#.#.###################################.#.#.#.#
#.#.#.#.....................................#.#.#.#
#.#.#.#######################################.#.#.#
#.#.#.........................................#.#.#
#.#.###########################################.#.#
#.#.............................................#.#
#.###############################################.#
#.................................................#
###################################################